----------------------------------------------------------------------------------------------------------------------------------------------------------------------------------------------------------------------------------
---------------------------------------------------------------------------------------------?---------------------------------------------------------------------------------------------S--------------------------------------
----------------------------------------------------------------------------------------------------------------------------------------------------------------------------------------------------------------------------------
----------------------------------------------------------------------------------------------------------------------------------------------------------------------------------------------------------------------------------
---------------------------------Q-?-Q----------------SSS-----------------------------------S----------------------------------SSSSSSSS--------------------------------------------------XXXX--------------------------XXX--------
-----------------------------------------------------------------------------------------------------------------------------------------------------------------------------------------XXX----------------E---------XEXX--------
---------------------------------------E---E--------------XXXXXXXX---------------------------------------------------------------------------------------------------------------------------------------------------EXXXX--------
---------------------------------------------------------XXXXXXXX-------------------------------------------------------------------------------------------------------E---E---------------------------------------EXXXXX--------
-----------------------------E---E--E---XXXXXXX---------XXXX----------------------------XXXXXXX-----------------------------------SSSSS------QQQQ------------------------------------------------------------------XXXXXXX--------
---------------XXXXXXXXXXXXXXXXXXEXXXXXXX--------------XXXXX--------------------------------------------------------------------<>----------------------------XXX---XXX----XXX----XXX----------------E------------XXXXXXXX--------
--------------XXX-------------------------------------XXXXXX----------------<>---------------------------XXXX-------------------[]-------------E--------------XX----XX-----XX-----XX-----------------------------XXXXXXXXX--------
-------------XXX-------------------------------------XXXXXX----<>-----<>----[]-----<>------------------------------------XX-----[]-------------------------X----------------------------XX----------------------XXXXXXXXXX-------X
XXXXXXXXXXXXXXXX-------------------------------------XXXXXX----[]-----[]----[]-----[]------------XXX-----------XXX-------XXXXXXXXXXXXXXXXXXXXXXXXXXXXXXXXXXX----------------------------XXXXXXXXXXXXXXXXXXXXXXXXXXXXXXXXXXXXXXXXXX
XXXXXXXXXXXXXXXX-------------------------------------XXXXXX----[]-----[]----[]-----[]------------------------------------XXXXXXXXXXXXXXXXXXXXXXXXXXXXXXXXXXX----------------------------XXXXXXXXXXXXXXXXXXXXXXXXXXXXXXXXXXXXXXXXXX
